Haus -> House
Katze -> Cat
Hund -> Dog
Baum -> Tree
Auto -> Car
Buch -> Book
Tisch -> Table
Stuhl -> Chair
Computer -> Computer
Telefon -> Telephone
Stift -> Pen
Papier -> Paper
Fenster -> Window
Tür -> Door
Bett -> Bed
Lampe -> Lamp
Garten -> Garden
Blume -> Flower
Fluss -> River
Berg -> Mountain
See -> Lake
Sonne -> Sun
Mond -> Moon
Stern -> Star
Wolke -> Cloud
Regen -> Rain
Schnee -> Snow
Wind -> Wind
Feuer -> Fire
Erde -> Earth
Himmel -> Sky
Stadt -> Town
Dorf -> Village
Straße -> Street
Brücke -> Bridge
Flughafen -> Airport
Zug -> Train
Bus -> Bus
Fahrrad -> Bicycle
Boot -> Boat
Schiff -> Ship
Flugzeug -> Aeroplane
Hubschrauber -> Helicopter
Restaurant -> Restaurant
Hotel -> Hotel
Krankenhaus -> Hospital
Schule -> School
Universität -> University
Bank -> Bank
Markt -> Market
Laden -> Shop
Park -> Park
Strand -> Beach
Schwimmbad -> Swimming pool
Bibliothek -> Library
Museum -> Museum
Kino -> Cinema
Theater -> Theatre
Musik -> Music
Tanz -> Dance
Kunst -> Art
Geschichte -> History
Wissenschaft -> Science
Mathematik -> Mathematics
Sprache -> Language
Englisch -> English
Deutsch -> German
Französisch -> French
Spanisch -> Spanish
Italienisch -> Italian
Chinesisch -> Chinese
Japanisch -> Japanese
Russisch -> Russian
Indisch -> Indian
Australisch -> Australian
Kanadisch -> Canadian
Amerikanisch -> American
Brasilianisch -> Brazilian
Mexikanisch -> Mexican
Argentinisch -> Argentinian
Afrikanisch -> African
Europäisch -> European
Asiatisch -> Asian
Ozeanisch -> Oceanic
Kontinent -> Continent
Insel -> Island
Ozean -> Ocean
Meer -> Sea
Strand -> Beach
Berg -> Mountain
Wald -> Forest
Dschungel -> Jungle
Wüste -> Desert
See -> Lake
Fluss -> River
ich -> I
du -> You
er -> He
sie -> She
es -> It
wir -> We
sie -> They
sind -> Are
ist -> Is
war -> Was
waren -> Were
werde -> Will be
werde -> Will be
kann -> Can
konnte -> Could
darf -> May
könnte -> Could
muss -> Must
sollte -> Should
habe -> Have
hat -> Has
hatte -> Had
tun -> Do
tut -> Does
tat -> Did
sage -> Say
spreche -> Speak
zuhören -> Listen
hören -> Hear
sehen -> See
schauen -> Look
beobachten -> Observe
bemerken -> Notice
finden -> Find
bekommen -> Get
erhalten -> Get
gehen -> Go
kommen -> Come
starten -> Start
stoppen -> Stop
halten -> Hold
machen -> Do