House -> Haus
Cat -> Katze
Dog -> Hund
Tree -> Baum
Car -> Auto
Book -> Buch
Table -> Tisch
Chair -> Stuhl
Computer -> Computer
Telephone -> Telefon
Pen -> Stift
Paper -> Papier
Window -> Fenster
Door -> Tür
Bed -> Bett
Lamp -> Lampe
Garden -> Garten
Flower -> Blume
River -> Fluss
Mountain -> Berg
Lake -> See
Sun -> Sonne
Moon -> Mond
Star -> Stern
Cloud -> Wolke
Rain -> Regen
Snow -> Schnee
Wind -> Wind
Fire -> Feuer
Earth -> Erde
Sky -> Himmel
Town -> Stadt
Village -> Dorf
Street -> Straße
Bridge -> Brücke
Airport -> Flughafen
Train -> Zug
Bus -> Bus
Bicycle -> Fahrrad
Boat -> Boot
Ship -> Schiff
Aeroplane -> Flugzeug
Helicopter -> Hubschrauber
Restaurant -> Restaurant
Hotel -> Hotel
Hospital -> Krankenhaus
School -> Schule
University -> Universität
Bank -> Bank
Market -> Markt
Shop -> Laden
Park -> Park
Beach -> Strand
Swimming -> pool Schwimmbad
Library -> Bibliothek
Museum -> Museum
Cinema -> Kino
Theatre -> Theater
Music -> Musik
Dance -> Tanz
Art -> Kunst
History -> Geschichte
Science -> Wissenschaft
Mathematics -> Mathematik
Language -> Sprache
English -> Englisch
German -> Deutsch
French -> Französisch
Spanish -> Spanisch
Italian -> Italienisch
Chinese -> Chinesisch
Japanese -> Japanisch
Russian -> Russisch
Indian -> Indisch
Australian -> Australisch
Canadian -> Kanadisch
American -> Amerikanisch
Brazilian -> Brasilianisch
Mexican -> Mexikanisch
Argentinian -> Argentinisch
African -> Afrikanisch
European -> Europäisch
Asian -> Asiatisch
Oceanic -> Ozeanisch
Continent -> Kontinent
Island -> Insel
Ocean -> Ozean
Sea -> Meer
Beach -> Strand
Mountain -> Berg
Forest -> Wald
Jungle -> Dschungel
Desert -> Wüste
Lake -> See
River -> Fluss
I -> Ich
You -> Du
He -> Er
She -> Sie
It -> Es
We -> Wir
They -> Sie
Are -> Sind
Is -> Ist
Was -> War
Were -> Waren
Will -> be Werde
Will -> be Werde
Can -> Kann
Could -> Konnte
May -> Darf
Could -> Könnte
Must -> Muss
Should -> Sollte
Have -> Habe
Has -> Hat
Had -> Hatte
Do -> Tun
Does -> Tut
Did -> Tat
Say -> Sage
Speak -> Spreche
Listen -> Zuhören
Hear -> Hören
See -> Sehen
Look -> Schauen
Observe -> Beobachten
Notice -> Bemerken
Find -> Finden
Get -> Bekommen
Get -> Erhalten
Go -> Gehen
Come -> Kommen
Start -> Starten
Stop -> Stoppen
Hold -> Halten
Do -> Machen