дом -> Haus
кошка -> Katze
собака -> Hund
дерево -> Baum
автомобиль -> Auto
книга -> Buch
стол -> Tisch
стул -> Stuhl
компьютер -> Computer
телефон -> Telefon
ручка -> Stift
бумага -> Papier
окно -> Fenster
дверь -> Tür
кровать -> Bett
лампа -> Lampe
сад -> Garten
цветок -> Blume
река -> Fluss
гора -> Berg
озеро -> See
солнце -> Sonne
луна -> Mond
звезда -> Stern
облако -> Wolke
дождь -> Regen
снег -> Schnee
ветер -> Wind
огонь -> Feuer
земля -> Erde
небо -> Himmel
город -> Stadt
деревня -> Dorf
дорога -> Straße
мост -> Brücke
аэропорт -> Flughafen
поезд -> Zug
автобус -> Bus
велосипед -> Fahrrad
лодка -> Boot
корабль -> Schiff
самолёт -> Flugzeug
вертолёт -> Hubschrauber
ресторан -> Restaurant
отель -> Hotel
больница -> Krankenhaus
школа -> Schule
университет -> Universität
банк -> Bank
рынок -> Markt
магазин -> Laden
парк -> Park
пляж -> Strand
бассейн -> Schwimmbad
библиотека -> Bibliothek
музей -> Museum
кинотеатр -> Kino
театр -> Theater
музыка -> Musik
танец -> Tanz
искусство -> Kunst
история -> Geschichte
наука -> Wissenschaft
математика -> Mathematik
язык -> Sprache
Английский -> Englisch
Немецкий -> Deutsch
Французский -> Französisch
Испанский -> Spanisch
Итальянский -> Italienisch
Китайский -> Chinesisch
Японский -> Japanisch
Русский -> Russisch
Индийский -> Indisch
Австралийский -> Australisch
Канадец -> Kanadisch
Американец -> Amerikanisch
Бразилец -> Brasilianisch
Мексиканец -> Mexikanisch
Аргентинец -> Argentinisch
Африка -> Afrikanisch
Европеец -> Europäisch
Азиатский -> Asiatisch
Океания -> Ozeanisch
континент -> Kontinent
остров -> Insel
океан -> Ozean
море -> Meer
пляж -> Strand
гора -> Berg
лес -> Wald
джунгли -> Dschungel
пустыня -> Wüste
озеро -> See
река -> Fluss
I -> ich
ты -> du
он -> er
она -> sie
это -> es
мы -> wir
они -> sie
я -> bin
есть -> sind
есть -> ist
был -> war
были -> waren
будет -> werde
будет -> werde
может -> kann
мог -> konnte
может -> darf
может -> könnte
должен -> muss
должен -> sollte
иметь -> habe
имеет -> hat
имел -> hatte
делать -> tun
делает -> tut
сделал -> tat
сказать -> sage
говорить -> spreche
слушать -> zuhören
слышать -> hören
видеть -> sehen
смотреть -> schauen
наблюдать -> beobachten
заметить -> bemerken
найти -> finden
получать -> bekommen
получать -> erhalten
идти -> gehen
приходить -> kommen
начать -> starten
остановиться -> stoppen
держать -> halten
продолжать -> machen