Haus -> дом
Katze -> кошка
Hund -> собака
Baum -> дерево
Auto -> автомобиль
Buch -> книга
Tisch -> стол
Stuhl -> стул
Computer -> компьютер
Telefon -> телефон
Stift -> ручка
Papier -> бумага
Fenster -> окно
Tür -> дверь
Bett -> кровать
Lampe -> лампа
Garten -> сад
Blume -> цветок
Fluss -> река
Berg -> гора
See -> озеро
Sonne -> солнце
Mond -> луна
Stern -> звезда
Wolke -> облако
Regen -> дождь
Schnee -> снег
Wind -> ветер
Feuer -> огонь
Erde -> земля
Himmel -> небо
Stadt -> город
Dorf -> деревня
Straße -> дорога
Brücke -> мост
Flughafen -> аэропорт
Zug -> поезд
Bus -> автобус
Fahrrad -> велосипед
Boot -> лодка
Schiff -> корабль
Flugzeug -> самолёт
Hubschrauber -> вертолёт
Restaurant -> ресторан
Hotel -> отель
Krankenhaus -> больница
Schule -> школа
Universität -> университет
Bank -> банк
Markt -> рынок
Laden -> магазин
Park -> парк
Strand -> пляж
Schwimmbad -> бассейн
Bibliothek -> библиотека
Museum -> музей
Kino -> кинотеатр
Theater -> театр
Musik -> музыка
Tanz -> танец
Kunst -> искусство
Geschichte -> история
Wissenschaft -> наука
Mathematik -> математика
Sprache -> язык
Englisch -> Английский
Deutsch -> Немецкий
Französisch -> Французский
Spanisch -> Испанский
Italienisch -> Итальянский
Chinesisch -> Китайский
Japanisch -> Японский
Russisch -> Русский
Indisch -> Индийский
Australisch -> Австралийский
Kanadisch -> Канадец
Amerikanisch -> Американец
Brasilianisch -> Бразилец
Mexikanisch -> Мексиканец
Argentinisch -> Аргентинец
Afrikanisch -> Африка
Europäisch -> Европеец
Asiatisch -> Азиатский
Ozeanisch -> Океания
Kontinent -> континент
Insel -> остров
Ozean -> океан
Meer -> море
Strand -> пляж
Berg -> гора
Wald -> лес
Dschungel -> джунгли
Wüste -> пустыня
See -> озеро
Fluss -> река
ich -> I
du -> ты
er -> он
sie -> она
es -> это
wir -> мы
sie -> они
bin -> я
sind -> есть
ist -> есть
war -> был
waren -> были
werde -> будет
werde -> будет
kann -> может
konnte -> мог
darf -> может
könnte -> может
muss -> должен
sollte -> должен
habe -> иметь
hat -> имеет
hatte -> имел
tun -> делать
tut -> делает
tat -> сделал
sage -> сказать
spreche -> говорить
zuhören -> слушать
hören -> слышать
sehen -> видеть
schauen -> смотреть
beobachten -> наблюдать
bemerken -> заметить
finden -> найти
bekommen -> получать
erhalten -> получать
gehen -> идти
kommen -> приходить
starten -> начать
stoppen -> остановиться
halten -> держать
machen -> продолжать